###########
#####---###
#####-#####
#<...-....#
#####-#####
#....-<...#
#####-#####
#....-...<#
#####-#####
#..<.-....#
#####-#####
#<...-....#
#####@#####
###########